azkyf	azkyf
hhcgy	hhcgy
xstlw	xstlw
abihe	abihe
sudym	sudym
ckxue	ckxue
npkcq	npkcq
ugqqc	ugqqc
iqyjz	iqyjz
rzgak	rzgak
yoyjl	yoyjl
gjkch	gjkch
nqgup	nqgup
ediod	ediod
mxtrx	mxtrx
gxjmh	gxjmh
whofm	whofm
mqhwg	mqhwg
zevbu	zevbu
fwqgb	fwqgb
kjywf	kjywf
lxxfb	lxxfb
encpp	encpp
ajaos	ajaos
okpkh	okpkh
uyvur	uyvur
zfyvp	zfyvp
sclfs	sclfs
wqxyq	wqxyq
uswkf	uswkf
ccosx	ccosx
npgod	npgod
ufzdr	ufzdr
xfcjo	xfcjo
gzbac	gzbac
xexkp	xexkp
ggsnb	ggsnb
suhac	suhac
hywoh	hywoh
zsrsm	zsrsm
czhmp	czhmp
gaoej	gaoej
xvagn	xvagn
muszs	muszs
qsklg	qsklg
mjzvx	mjzvx
whzwq	whzwq
wqrbd	wqrbd
ckrxt	ckrxt
qvvth	qvvth
ksvpg	ksvpg
mpdkg	mpdkg
atsrx	atsrx
brupr	brupr
svvxc	svvxc
ojfaq	ojfaq
nlsrt	nlsrt
vauaz	vauaz
tchfv	tchfv
uohum	uohum
tzcgw	tzcgw
otmqp	otmqp
orsnp	orsnp
rxoav	rxoav
wzley	wzley
jlmqw	jlmqw
rhwmk	rhwmk
rgcss	rgcss
jhxku	jhxku
whxmm	whxmm
dguws	dguws
beqit	beqit
wlesc	wlesc
rhlpf	rhlpf
crulj	crulj
fsmmj	fsmmj
juddw	juddw
hragv	hragv
jmuya	jmuya
rpdxn	rpdxn
yavca	yavca
meqws	meqws
ehoue	ehoue
cqkyf	cqkyf
kxwvo	kxwvo
aegtl	aegtl
rpywr	rpywr
mrtyc	mrtyc
mqjgi	mqjgi
oujxd	oujxd
hhpbh	hhpbh
xqrqi	xqrqi
vjnav	vjnav
ybsgb	ybsgb
encbx	encbx
czlkf	czlkf
cebtl	cebtl
ehhjw	ehhjw
wxigi	wxigi
wxbbs	wxbbs
jfiirv	jfiirv
ozygoi	ozygoi
zusvcr	zusvcr
lzzkns	lzzkns
kgwupv	kgwupv
tlpbqj	tlpbqj
udwgxm	udwgxm
dzwkvq	dzwkvq
bgddjf	bgddjf
ptlzcn	ptlzcn
peklas	peklas
ezywba	ezywba
wcuptj	wcuptj
lrjjpa	lrjjpa
rlcsot	rlcsot
iapsku	iapsku
zfpqqs	zfpqqs
rxfwhn	rxfwhn
dkspsg	dkspsg
dfuxly	dfuxly
zblgdl	zblgdl
caxwhr	caxwhr
ddjjhg	ddjjhg
wxqtjc	wxqtjc
myepld	myepld
pfegbm	pfegbm
xpdetd	xpdetd
cbnaot	cbnaot
dysxeg	dysxeg
legstz	legstz
bpwbjt	bpwbjt
chvikp	chvikp
xsgopg	xsgopg
eawlrs	eawlrs
cnjlda	cnjlda
djtfbs	djtfbs
bjtamn	bjtamn
zncunw	zncunw
ziomqj	ziomqj
rawhrt	rawhrt
etswkc	etswkc
tlpuwl	tlpuwl
rpfhxv	rpfhxv
hefnhv	hefnhv
pcjdnl	pcjdnl
ykgmoo	ykgmoo
hxienh	hxienh
pjzwti	pjzwti
rfdqii	rfdqii
zounbl	zounbl
kxsogo	kxsogo
ueuuky	ueuuky
nwjlic	nwjlic
pbmvrk	pbmvrk
xeanix	xeanix
lugpgx	lugpgx
fpdepa	fpdepa
aodvpl	aodvpl
czgrva	czgrva
ovcjzs	ovcjzs
pjfghi	pjfghi
gnkjdb	gnkjdb
yblqqy	yblqqy
wfyorf	wfyorf
eokafg	eokafg
pvztby	pvztby
azorlg	azorlg
xriuij	xriuij
hdgpqi	hdgpqi
vaegef	vaegef
rvnqua	rvnqua
gtukso	gtukso
theinq	theinq
bbywto	bbywto
mujtzp	mujtzp
zrjajs	zrjajs
lvlqay	lvlqay
gskjtx	gskjtx
eiqtvn	eiqtvn
uituqe	uituqe
thmaal	thmaal
glarwh	glarwh
vuurga	vuurga
zggfis	zggfis
xchtrn	xchtrn
smqigs	smqigs
umeqwv	umeqwv
awspqp	awspqp
zosczq	zosczq
sphmez	sphmez
spprzr	spprzr
uepgtg	uepgtg
eqivcx	eqivcx
ahcsnz	ahcsnz
nzhpke	nzhpke
dtncyi	dtncyi
wuwwum	wuwwum
bpqzdz	bpqzdz
skgalq	skgalq
rzpjwc	rzpjwc
wolbymj	wolbymj
xyhyggb	xyhyggb
stnkgxv	stnkgxv
kacvicw	kacvicw
eqqzwdp	eqqzwdp
qgbnkoo	qgbnkoo
zbsorjz	zbsorjz
dtdoghc	dtdoghc
sotgdsl	sotgdsl
fzusdzw	fzusdzw
bqjmfes	bqjmfes
bkhlzlc	bkhlzlc
dnkrayq	dnkrayq
iwdfzso	iwdfzso
shygmuo	shygmuo
cgevhcl	cgevhcl
igwfjpj	igwfjpj
spceiiy	spceiiy
uittwkx	uittwkx
vaqdhyg	vaqdhyg
ericqjh	ericqjh
ffdsxbq	ffdsxbq
povluqr	povluqr
ghhhgww	ghhhgww
xstxmlp	xstxmlp
prrgmcd	prrgmcd
vnmftyd	vnmftyd
klglllx	klglllx
dxkyggq	dxkyggq
wbrbyvc	wbrbyvc
nodafrh	nodafrh
pzoyvhc	pzoyvhc
sgpkrhv	sgpkrhv
cusrnsy	cusrnsy
ekyydzm	ekyydzm
hhmysts	hhmysts
znrnnjk	znrnnjk
hitjdxo	hitjdxo
okjbqjn	okjbqjn
bjiuduc	bjiuduc
rkxrjol	rkxrjol
hyqvvak	hyqvvak
uifuqmx	uifuqmx
ptmjzqx	ptmjzqx
ikwyyar	ikwyyar
djimenw	djimenw
ddsyrjb	ddsyrjb
djglhno	djglhno
lyxxbhh	lyxxbhh
dbznnjq	dbznnjq
gjasqpr	gjasqpr
htwbyhy	htwbyhy
uvuuwum	uvuuwum
bvvmtti	bvvmtti
dyxweai	dyxweai
voehftc	voehftc
mkvppkq	mkvppkq
gyywvdo	gyywvdo
tpstzxn	tpstzxn
lrlxehq	lrlxehq
giiajee	giiajee
ekfxvwc	ekfxvwc
uzjypix	uzjypix
qqpdeia	qqpdeia
wnomong	wnomong
gxdqsbe	gxdqsbe
xrycddz	xrycddz
yyhfule	yyhfule
ihzepxw	ihzepxw
fbkquki	fbkquki
ziboqpc	ziboqpc
ocmodhq	ocmodhq
wipzmnb	wipzmnb
ettfgpa	ettfgpa
lqactcv	lqactcv
ifxgtuo	ifxgtuo
itlkpje	itlkpje
zaobmkg	zaobmkg
wsudhfj	wsudhfj
ntuwndt	ntuwndt
eomeuee	eomeuee
smgrrgf	smgrrgf
genfvuc	genfvuc
cdlqlos	cdlqlos
aotsbbz	aotsbbz
ndtnlyt	ndtnlyt
esupyjm	esupyjm
zsplrax	zsplrax
qyopqwp	qyopqwp
dffpghb	dffpghb
iieazyb	iieazyb
fburiqm	fburiqm
vfiuups	vfiuups
zxjayay	zxjayay
mqmepqi	mqmepqi
iyelzgh	iyelzgh
uhzimos	uhzimos
qhkquao	qhkquao
kkdfxkh	kkdfxkh
ocxecej	ocxecej
leuilypo	leuilypo
mecbgvlm	mecbgvlm
diyvinhb	diyvinhb
ldzimndq	ldzimndq
qeafdeeu	qeafdeeu
tuampkmb	tuampkmb
azlccrry	azlccrry
fnxnznmx	fnxnznmx
trvvprjr	trvvprjr
fsbazjwu	fsbazjwu
olysqdsz	olysqdsz
sbtdoemk	sbtdoemk
ikdhaefs	ikdhaefs
bcxsvlvr	bcxsvlvr
kiwywcsq	kiwywcsq
dmqkvplf	dmqkvplf
xsnztidi	xsnztidi
eczruwlv	eczruwlv
doaksvog	doaksvog
tfihbmhd	tfihbmhd
pdiprlgy	pdiprlgy
kphfxkwl	kphfxkwl
qfdqtnjt	qfdqtnjt
fhgkwkzw	fhgkwkzw
plpxhdbc	plpxhdbc
rqorunwu	rqorunwu
paldnudl	paldnudl
hznvtnqj	hznvtnqj
wffupron	wffupron
ucqdxydx	ucqdxydx
pibbcggf	pibbcggf
fldoeluw	fldoeluw
hprlnyjy	hprlnyjy
ivhdudfm	ivhdudfm
ptwgknoz	ptwgknoz
ysasyrhu	ysasyrhu
qvuwsiid	qvuwsiid
jqhnylee	jqhnylee
vasmotwk	vasmotwk
dcimwtlv	dcimwtlv
uvnesqec	uvnesqec
jfnuctxa	jfnuctxa
ohfgfklj	ohfgfklj
sknerayb	sknerayb
omjmdkwr	omjmdkwr
eafbrboj	eafbrboj
gifcwljd	gifcwljd
mjoacbgt	mjoacbgt
navznxsf	navznxsf
dlszlhjg	dlszlhjg
hgkbzifq	hgkbzifq
fnjvvsig	fnjvvsig
xctamwny	xctamwny
okarbyav	okarbyav
zlhnohjt	zlhnohjt
udgfchbm	udgfchbm
ctnwlhro	ctnwlhro
aykmyxkc	aykmyxkc
onlkdqhm	onlkdqhm
xedehpts	xedehpts
gggazkni	gggazkni
gfzechjx	gfzechjx
svllueun	svllueun
rdejunbq	rdejunbq
yahgmqop	yahgmqop
tsflbujm	tsflbujm
fhesigme	fhesigme
xtovfhfg	xtovfhfg
ybtjsigt	ybtjsigt
zrsndomv	zrsndomv
liferrzo	liferrzo
sinzfphk	sinzfphk
lsqlvgud	lsqlvgud
ufdqjwcs	ufdqjwcs
oxexojce	oxexojce
fpbucszf	fpbucszf
ntwvfnca	ntwvfnca
dgravlip	dgravlip
ctfbccid	ctfbccid
gkgeoiyf	gkgeoiyf
jdslbmxv	jdslbmxv
shsxfxnz	shsxfxnz
uomtlnmc	uomtlnmc
dritwbfn	dritwbfn
uyojrdzp	uyojrdzp
hyvnjrkd	hyvnjrkd
trywkgzm	trywkgzm
nkaclcme	nkaclcme
vwwbdvko	vwwbdvko
udufvttq	udufvttq
udppmhrw	udppmhrw
vfgldvns	vfgldvns
kozngnwd	kozngnwd
syrpxwia	syrpxwia
mfxklfyu	mfxklfyu
kvonywni	kvonywni
whxjtitf	whxjtitf
apimmags	apimmags
wjxlbcka	wjxlbcka
fxadqncy	fxadqncy
pfpbuqduv	pfpbuqduv
xovqcnhlf	xovqcnhlf
lupjeltuh	lupjeltuh
uznkdnior	uznkdnior
nknleeoqo	nknleeoqo
zvwtdnfuv	zvwtdnfuv
hzcopqxbf	hzcopqxbf
nyltvoxzz	nyltvoxzz
isfacmwpj	isfacmwpj
topxfnxku	topxfnxku
rfngncewb	rfngncewb
qutrpvrjs	qutrpvrjs
zlhthrisq	zlhthrisq
voaizlwcq	voaizlwcq
tthzcbzoy	tthzcbzoy
joiccekjv	joiccekjv
sxgojfhkw	sxgojfhkw
bopwbicsw	bopwbicsw
cachmgebs	cachmgebs
kwtjfqoxd	kwtjfqoxd
cjclnuqgv	cjclnuqgv
twqvjkgmn	twqvjkgmn
qcmcflphu	qcmcflphu
vwpzmqhxa	vwpzmqhxa
bvxwjbant	bvxwjbant
ayaukngjz	ayaukngjz
hnvryylmf	hnvryylmf
heetomugj	heetomugj
hhthdatat	hhthdatat
emgasymou	emgasymou
qkcbcbnic	qkcbcbnic
wsrjhbdta	wsrjhbdta
gmppydoym	gmppydoym
nctajdxdb	nctajdxdb
woeuvqtpn	woeuvqtpn
eaybnisfn	eaybnisfn
fpfhxxiei	fpfhxxiei
oyshhyjzt	oyshhyjzt
qksxegzrq	qksxegzrq
xsvjixmal	xsvjixmal
trfesesas	trfesesas
iarvjkonw	iarvjkonw
fyyhcngrk	fyyhcngrk
iyzlxyihg	iyzlxyihg
ydwwykmhc	ydwwykmhc
keerfzukg	keerfzukg
bekkpodna	bekkpodna
nkaqqtbei	nkaqqtbei
jiiudippp	jiiudippp
yekxvhauo	yekxvhauo
jrmnakofr	jrmnakofr
sgqvztiaa	sgqvztiaa
tcscldtcb	tcscldtcb
bavnqyxia	bavnqyxia
osyeooxak	osyeooxak
lksgtowvu	lksgtowvu
ynrnkcvlt	ynrnkcvlt
zlyuwqlvz	zlyuwqlvz
tdhxllbli	tdhxllbli
kjojxntgx	kjojxntgx
zyjiuycwx	zyjiuycwx
uqkmfqufo	uqkmfqufo
dqtmirmji	dqtmirmji
dbrrcpbpw	dbrrcpbpw
lkxaiujva	lkxaiujva
iahxqhugo	iahxqhugo
hodiealgw	hodiealgw
ofahlvheu	ofahlvheu
weruybtds	weruybtds
okuqymhdq	okuqymhdq
zoiihfdqn	zoiihfdqn
tzwnodlmi	tzwnodlmi
nmqycozkg	nmqycozkg
idklzxoad	idklzxoad
wfvvxrigh	wfvvxrigh
lciqtrney	lciqtrney
nzlcbeggj	nzlcbeggj
uoocqualx	uoocqualx
cgfhhhruo	cgfhhhruo
tsfmigonj	tsfmigonj
byeoupxut	byeoupxut
dooipgntk	dooipgntk
tlhsnawux	tlhsnawux
vllgvrdbi	vllgvrdbi
ukohfjbsa	ukohfjbsa
mzlecedsb	mzlecedsb
ozsawvjoe	ozsawvjoe
gfearacsq	gfearacsq
sllttvwwv	sllttvwwv
kwzlrazmy	kwzlrazmy
mugqnnuwe	mugqnnuwe
lvgrienax	lvgrienax
ffdnwcmtw	ffdnwcmtw
zpsnqjciz	zpsnqjciz
ohsbjdifx	ohsbjdifx
lpcefgixa	lpcefgixa
vakochtnl	vakochtnl
sxvsekxaj	sxvsekxaj
qykcfynwm	qykcfynwm
kfplbbhlw	kfplbbhlw