zsmff	zsmff
tqqfy	tqqfy
xjhcl	xjhcl
vuwvz	vuvuwvz
djcxs	djcxs
gyykc	gyykc
gcbvl	gcbvl
xbrzs	xbrzs
erttr	erttr
aeaqu	aeaqu
gzlab	gzlab
ycwui	ycwui
ltdwo	ltdwo
qapow	qaqapow
kqbnx	kqbnx
uvhwg	uvhwg
tsbbk	tsbbk
rygsg	rygsg
hjgkm	hjgkm
dhije	dhije
krbnr	krbnr
qjjvr	qjjvr
rirla	ririrla
tjquv	tjquv
ajhhc	ajhhc
jhrne	jhrne
jisfh	jijisfh
xclol	xclol
jfsjp	jfsjp
ougdv	ougdv
svwoh	svwoh
hgepu	hgepu
trthe	trthe
ykeze	ykeze
chtnt	chtnt
tuhba	tutuhba
fjzzy	fjzzy
ieqdb	ieqdb
bwmws	bwmws
rhteq	rhteq
kcoqr	kcoqr
qceuq	qceuq
joayg	jojoayg
rmloy	rmloy
wdfug	wdfug
nozyf	nonozyf
gvrak	gvrak
ntpwf	ntpwf
uanzr	uanzr
gramk	gramk
yayoj	yayayoj
kymel	kymel
tfwjw	tfwjw
keeop	kekeeop
nwliw	nwliw
ltvez	ltvez
fytin	fytin
blvfr	blvfr
xnbnq	xnbnq
bcagj	bcagj
gflep	gflep
qgkkq	qgkkq
dzrxw	dzrxw
whgon	whgon
msrye	msrye
hljna	hljna
dglzb	dglzb
inluc	inluc
yctqb	yctqb
mnwsz	mnwsz
ppikq	ppikq
zkhsl	zkhsl
hzknn	hzknn
katxx	kakatxx
gkxii	gkxii
usyzx	usyzx
pyepj	pyepj
sckpb	sckpb
jbexe	jbexe
emslj	emslj
ejpsj	ejpsj
sqhcm	sqhcm
dosiz	dodosiz
ldnnt	ldnnt
tpyzv	tpyzv
vfirl	vfirl
bddor	bddor
nolzz	nonolzz
ummrn	ummrn
gisze	gigisze
pewvh	pepewvh
rzzqp	rzzqp
iujgn	iujgn
bpufl	bpufl
umuxi	umuxi
ekxgr	ekxgr
jpyye	jpyye
bbqpy	bbqpy
rbzom	rbzom
tdiek	tdiek
xnztik	xnztik
bcpwvc	bcpwvc
czquef	czquef
xwzutv	xwzutv
szyoed	szyoed
wnacvs	wnacvs
pduqhc	pduqhc
fqkshb	fqkshb
zfeqmj	zfeqmj
lpziwr	lpziwr
dzphul	dzphul
rznpdh	rznpdh
nssjjw	nssjjw
xyseib	xyseib
tljdvn	tljdvn
jzwras	jzwras
iudoub	iudoub
ckowaw	ckowaw
kanxst	kakanxst
lrfani	lrfani
mtykdl	mtykdl
vwilqa	vwilqa
ewcfiw	ewcfiw
eqwisx	eqwisx
tcfwqd	tcfwqd
qxtqev	qxtqev
wixzya	wiwixzya
wmkvlz	wmkvlz
dajucp	dadajucp
dflezo	dflezo
rpfomv	rpfomv
glyily	glyily
abnqnz	abnqnz
eumdsc	eumdsc
biznkv	bibiznkv
xyhpdj	xyhpdj
iqjwll	iqjwll
qkdiaa	qkdiaa
dzhszt	dzhszt
smmowz	smmowz
hzyrie	hzyrie
doahed	dodoahed
slcidz	slcidz
bbdxli	bbdxli
merbkr	memerbkr
lpkvmc	lpkvmc
ihfkxo	ihfkxo
grlnmx	grlnmx
lcxviz	lcxviz
mywljz	mywljz
tusifw	tutusifw
zzmpyh	zzmpyh
bwyhra	bwyhra
imuhrv	imuhrv
yliuoi	yliuoi
okeoym	okeoym
hkpynn	hkpynn
chbisj	chbisj
mcoqej	mcoqej
gyeykx	gyeykx
cfdokd	cfdokd
iqykig	iqykig
vjzlyh	vjzlyh
hmcimk	hmcimk
zdmgsz	zdmgsz
jmafjb	jmafjb
dqkjkt	dqkjkt
skredf	skredf
oqczql	oqczql
inzukx	inzukx
heixeg	heheixeg
qtmozx	qtmozx
tlbrea	tlbrea
nnmwxs	nnmwxs
aglkdk	aglkdk
azweoh	azweoh
zfaaxi	zfaaxi
pfygic	pfygic
bjejhk	bjejhk
mbpabe	mbpabe
aypidf	aypidf
qxzcdt	qxzcdt
auomml	auomml
llivzp	llivzp
vwfeyu	vwfeyu
vtffke	vtffke
mkdpwu	mkdpwu
fwmdkj	fwmdkj
eqeglk	eqeglk
dtkbas	dtkbas
kaqmae	kakaqmae
wwvmnr	wwvmnr
tvkpsk	tvkpsk
djwzdi	djwzdi
bvbeaw	bvbeaw
ksoiuv	ksoiuv
frvusk	frvusk
bwdras	bwdras
mrbfwm	mrbfwm
pbozdw	pbozdw
pjnurik	pjnurik
fjjkqtq	fjjkqtq
izumzoy	izumzoy
rmukhrm	rmukhrm
hqnrvsu	hqnrvsu
fcqtyhh	fcqtyhh
hyolgvy	hyolgvy
gcjhakg	gcjhakg
ddvkezq	ddvkezq
nnaxkdv	nnaxkdv
btbqdgb	btbqdgb
kbzhzfc	kbzhzfc
bgcgcqy	bgcgcqy
beytksv	bebeytksv
wwqdmmf	wwqdmmf
xixkoda	xixixkoda
cpfndyj	cpfndyj
iocbexd	iocbexd
mqjuvlt	mqjuvlt
oniaufu	oniaufu
fxfkxbd	fxfkxbd
rpiaixt	rpiaixt
lhbgjqz	lhbgjqz
halhcou	hahalhcou
esiknsf	esiknsf
bwwmrop	bwwmrop
qvmnmmq	qvmnmmq
lwkqzsd	lwkqzsd
gvejlbu	gvejlbu
tpvqxpp	tpvqxpp
bueqflp	bubueqflp
uhodcft	uhodcft
sxbbchb	sxbbchb
mepxhjv	memepxhjv
xgdihrb	xgdihrb
fzbinnk	fzbinnk
aovfqqx	aovfqqx
dhepywy	dhepywy
ecabwro	ecabwro
pjzjvvg	pjzjvvg
zujzvbd	zuzujzvbd
wbnhrlc	wbnhrlc
qemryau	qeqemryau
edbruyc	edbruyc
osmffmm	osmffmm
kpfgllb	kpfgllb
yeksbnn	yeyeksbnn
rbcmxxq	rbcmxxq
edjunpo	edjunpo
utvietl	utvietl
ynqybzq	ynqybzq
nuassxd	nunuassxd
evgqaon	evgqaon
dulfeuy	dudulfeuy
giyvyqs	gigiyvyqs
lmklbwm	lmklbwm
yrtjwye	yrtjwye
umtviwf	umtviwf
mzooybg	mzooybg
rxjhqbv	rxjhqbv
exhzrwm	exhzrwm
aywgdva	aywgdva
isjqmda	isjqmda
bchtmts	bchtmts
fmburhp	fmburhp
zsmdcer	zsmdcer
thzhtas	thzhtas
vxjzpba	vxjzpba
cclwgrt	cclwgrt
dstjgad	dstjgad
gndgusv	gndgusv
mtebhwe	mtebhwe
tyvoodi	tyvoodi
droouci	droouci
lsyllzm	lsyllzm
yowknok	yoyowknok
rsnqtax	rsnqtax
qgrvwds	qgrvwds
wkprsez	wkprsez
pgwdehe	pgwdehe
quewwlr	ququewwlr
ohqwomd	ohqwomd
wwugxkt	wwugxkt
xjmmkoz	xjmmkoz
vutbszm	vuvutbszm
svhdgds	svhdgds
tqfboii	tqfboii
amvcrvc	amvcrvc
grernsp	grernsp
wkkcsdd	wkkcsdd
xwcbmuz	xwcbmuz
ybeocxj	ybeocxj
albahpv	albahpv
pixycpq	pipixycpq
gxeaanz	gxeaanz
dimrhyt	didimrhyt
ogdbnyr	ogdbnyr
jmemnfd	jmemnfd
rtatdto	rtatdto
rmeblch	rmeblch
dwxeaumj	dwxeaumj
bkmkhrwm	bkmkhrwm
nhmgrkoa	nhmgrkoa
jsyfeyuc	jsyfeyuc
ylmulpla	ylmulpla
fhdxlebf	fhdxlebf
eprpohpy	eprpohpy
hgiawaon	hgiawaon
vapldwyl	vavapldwyl
thtnmsfw	thtnmsfw
hmaptfba	hmaptfba
rumarbkc	rurumarbkc
waqsekcj	wawaqsekcj
qccveaww	qccveaww
lrpdvvsl	lrpdvvsl
zpqpnnls	zpqpnnls
xfnkzekx	xfnkzekx
dwcbdpsr	dwcbdpsr
kckykzer	kckykzer
mcirehxd	mcirehxd
oetiluvk	oetiluvk
mbdhnhzb	mbdhnhzb
iwjzkusr	iwjzkusr
gtxsncmd	gtxsncmd
vkguyqkf	vkguyqkf
zzdiefmd	zzdiefmd
yvqgkhwt	yvqgkhwt
mhhtlfbi	mhhtlfbi
ajwiotur	ajwiotur
aqdvcyah	aqdvcyah
aqejgixc	aqejgixc
kpuflffw	kpuflffw
kxzzjrep	kxzzjrep
incvpgsh	incvpgsh
olmukxvu	olmukxvu
okpdudic	okpdudic
wltncurr	wltncurr
tfgwabsi	tfgwabsi
kpyyojms	kpyyojms
uewemecr	uewemecr
avuepsur	avuepsur
vnrhwokf	vnrhwokf
qynrmtdk	qynrmtdk
egedbcuc	egedbcuc
ejkcrnpt	ejkcrnpt
upedgtkb	upedgtkb
faraguox	fafaraguox
gmsrnvop	gmsrnvop
wgzfhlji	wgzfhlji
njcxngrs	njcxngrs
opufrswm	opufrswm
wznvjcuk	wznvjcuk
uhupikcc	uhupikcc
qefydked	qeqefydked
vcwmtlby	vcwmtlby
idqntbcb	idqntbcb
mznubslx	mznubslx
dntheuof	dntheuof
korkpzpy	kokorkpzpy
gesfegfh	gegesfegfh
yxyizunq	yxyizunq
ahcojbok	ahcojbok
zxkwonop	zxkwonop
cipmkdus	cicipmkdus
tcmbdlyl	tcmbdlyl
gvoqtegu	gvoqtegu
odkafegj	odkafegj
lkpbudjv	lkpbudjv
effvaezh	effvaezh
khwdypjq	khwdypjq
hnvgpnhr	hnvgpnhr
yfyeygfi	yfyeygfi
bdiyfqla	bdiyfqla
teziqebw	teteziqebw
rlzllbqe	rlzllbqe
khshvtyu	khshvtyu
azmqxjrv	azmqxjrv
cappsfqk	cacappsfqk
jzhnnxuc	jzhnnxuc
anxhakns	anxhakns
ikaqqxgt	ikaqqxgt
kfddkqsy	kfddkqsy
thhdmogh	thhdmogh
rbjxxzgq	rbjxxzgq
srwopaip	srwopaip
ptwrutsi	ptwrutsi
wsqmapko	wsqmapko
qmtkihig	qmtkihig
huzbcaah	huhuzbcaah
qvczfsel	qvczfsel
docpxhcf	dodocpxhcf
yysoksdo	yysoksdo
yzzrifsz	yzzrifsz
jenckpvx	jejenckpvx
fnyzjwju	fnyzjwju
stbyiudb	stbyiudb
wgeyyzjp	wgeyyzjp
jpqdhnfq	jpqdhnfq
kkjjbimz	kkjjbimz
ycvochxw	ycvochxw
phqelytmd	phqelytmd
ycqncwfkd	ycqncwfkd
odbzcsofm	odbzcsofm
zzaidbppq	zzaidbppq
qyiopsxnj	qyiopsxnj
gxpdbnxvz	gxpdbnxvz
mputqfvvd	mputqfvvd
lskxxlfxh	lskxxlfxh
uzighmmrx	uzighmmrx
oktnsadeu	oktnsadeu
xozvmtwqv	xoxozvmtwqv
mowquukoc	momowquukoc
afzvwqwvg	afzvwqwvg
htwieckld	htwieckld
fczvnypmu	fczvnypmu
uawrmklhe	uawrmklhe
gftwyahvo	gftwyahvo
kgcyeckvp	kgcyeckvp
gqcwjedek	gqcwjedek
watdwfoku	wawatdwfoku
jccwlupxt	jccwlupxt
gnsbmqyle	gnsbmqyle
leuobmhki	leleuobmhki
rcgsrxqbj	rcgsrxqbj
obrlhqwut	obrlhqwut
kggllymts	kggllymts
qjgaruepl	qjgaruepl
feiwicnpn	fefeiwicnpn
areliupgt	areliupgt
hsuttwbcx	hsuttwbcx
sccalxavy	sccalxavy
rwupzozvr	rwupzozvr
lxjbspjjn	lxjbspjjn
nkipezhnm	nkipezhnm
lawerhiiy	lalawerhiiy
dcosmqgop	dcosmqgop
cvjjxdnnm	cvjjxdnnm
yivnutsnw	yiyivnutsnw
ehraxuimb	ehraxuimb
yjbvrelwq	yjbvrelwq
siyxdadhk	sisiyxdadhk
wmldfckzl	wmldfckzl
unegltfbq	unegltfbq
bmlguwnmm	bmlguwnmm
zqraepaja	zqraepaja
wwtirqanc	wwtirqanc
patoyfvqh	papatoyfvqh
whzigeqnk	whzigeqnk
ojhmldvgv	ojhmldvgv
bxaiwgqwh	bxaiwgqwh
wlvhdrjxi	wlvhdrjxi
swpugotzb	swpugotzb
mtduessny	mtduessny
nruihhbez	nruihhbez
gnfuiwlan	gnfuiwlan
kykqryadm	kykqryadm
bzpqoxlbn	bzpqoxlbn
sqbvbnmrj	sqbvbnmrj
zmnsljzxo	zmnsljzxo
yvcznihve	yvcznihve
tpaiyxrcv	tpaiyxrcv
utgykfneo	utgykfneo
rgcwwcelb	rgcwwcelb
vxjqoahnr	vxjqoahnr
atuhtbxgn	atuhtbxgn
fgyycvrvy	fgyycvrvy
zdvzfwcve	zdvzfwcve
ijgmrkkjd	ijgmrkkjd
djwowzodl	djwowzodl
syuvhrnpi	syuvhrnpi
tryatrilh	tryatrilh
vjycniwob	vjycniwob
nmufcxyjd	nmufcxyjd
vcgbipitf	vcgbipitf
ryyynhcnt	ryyynhcnt
scxzhmsyd	scxzhmsyd
xruqbkukk	xruqbkukk
ukwgilmtq	ukwgilmtq
bfyrtbojc	bfyrtbojc
qykqmyldb	qykqmyldb
rnnruybxz	rnnruybxz
bipyhizyn	bibipyhizyn
yvotddamc	yvotddamc
vwpfolcnx	vwpfolcnx
pzgjtriug	pzgjtriug
cefnwcbdc	cecefnwcbdc
pxjgxbilh	pxjgxbilh
yyilksdga	yyilksdga
kzlxzraoi	kzlxzraoi
xnuflipbt	xnuflipbt
ffgpjdmld	ffgpjdmld
krfryvoaj	krfryvoaj
hrairuzvk	hrairuzvk
ofhthzxds	ofhthzxds
npsnaodrx	npsnaodrx
lcqozcmbd	lcqozcmbd
lksgryhgd	lksgryhgd
uoxuecdlm	uoxuecdlm
oxdwrokgr	oxdwrokgr
surjuqyod	susurjuqyod