dqqto	dqqt
zmifw	zmfw
zdbne	zdbn
vdrnk	vdrnk
alsne	lsn
ezglg	zglg
pdkqr	pdkqr
dvigv	dvgv
ksowi	ksw
vqdac	vqdc
sexps	sxps
vloyu	vly
dtlfc	dtlfc
sejfw	sjfw
qjwzp	qjwzp
lvfls	lvfls
sezcx	szcx
etdba	tdb
tkscv	tkscv
tbfyc	tbfyc
fdjrd	fdjrd
nenov	nnv
yvnkj	yvnkj
nvzzr	nvzzr
hchjg	hchjg
awgiz	wgz
ttpsq	ttpsq
rjgau	rjg
osgmp	sgmp
xlsyw	xlsyw
miodw	mdw
rygtq	rygtq
urmjy	rmjy
riizb	rzb
wgatj	wgtj
qymzi	qymz
yceuf	ycf
kultx	kltx
caiap	cp
azyyk	zyyk
yaovj	yvj
idznb	dznb
tmiop	tmp
odtff	dtff
uoant	nt
wejzb	wjzb
lpjic	lpjc
lolem	llm
rhdkv	rhdkv
oifjo	fj
snems	snms
wpgzr	wpgzr
bqytq	bqytq
fydyx	fydyx
jgmri	jgmr
ayzfm	yzfm
glxgh	glxgh
pftog	pftg
dmbtz	dmbtz
axknr	xknr
dyqoh	dyqh
cuwen	cwn
bjztj	bjztj
awiix	wx
oewyn	wyn
qglun	qgln
bpiyb	bpyb
hfztr	hfztr
qazjt	qzjt
ljhdr	ljhdr
pvobf	pvbf
zhzpa	zhzp
qlvkk	qlvkk
khtls	khtls
dstda	dstd
sxmbg	sxmbg
otnmm	tnmm
qozdc	qzdc
fekdk	fkdk
xrfvn	xrfvn
khjyh	khjyh
mycxu	mycx
numpt	nmpt
qwqoi	qwq
dwtvf	dwtvf
yeren	yrn
vnlbu	vnlb
pcjzo	pcjz
tmvit	tmvt
mqtxf	mqtxf
empjw	mpjw
uvxae	vx
wmzay	wmzy
mchyb	mchyb
avlvy	vlvy
wbpln	wbpln
clnhu	clnh
ihuad	hd
wzwmf	wzwmf
iycos	ycs
wbusry	wbsry
njlsla	njlsl
hdeock	hdck
dzqliy	dzqly
rzsbpu	rzsbp
sztbkt	sztbkt
tlqycp	tlqycp
arkvpd	rkvpd
eswzeu	swz
kitfpg	ktfpg
dbgcmz	dbgcmz
sfsawi	sfsw
zyvskr	zyvskr
sprtja	sprtj
kptjqv	kptjqv
hmkhjj	hmkhjj
lazuiz	lzz
bdmvlb	bdmvlb
dbbvsh	dbbvsh
bwbajp	bwbjp
bbpcrp	bbpcrp
igjuil	gjl
syakxt	sykxt
xpjpte	xpjpt
gnlmxa	gnlmx
qqmjdh	qqmjdh
qcfkrj	qcfkrj
tcdtny	tcdtny
ldeyav	ldyv
peddpp	pddpp
vjiflh	vjflh
oyqljt	yqljt
aoktgp	ktgp
wwfoef	wwff
qjrnub	qjrnb
ydaawh	ydwh
krcaib	krcb
lwnejm	lwnjm
qgfpqx	qgfpqx
cvurau	cvr
qfsfzx	qfsfzx
qdlrgu	qdlrg
itfypw	tfypw
aivorm	vrm
cdxptk	cdxptk
nufvzl	nfvzl
ekplfh	kplfh
afuwxk	fwxk
vrupyc	vrpyc
oahuxk	hxk
vjrzep	vjrzp
qkzsit	qkzst
uhsgzg	hsgzg
tbxhqb	tbxhqb
ennoyn	nnyn
qoocvt	qcvt
aurddr	rddr
efrcqt	frcqt
rystli	rystl
ilwycf	lwycf
swxuzb	swxzb
evetec	vtc
zqeyty	zqyty
wafovf	wfvf
bafcrn	bfcrn
jecliu	jcl
vtroyg	vtryg
ufydjg	fydjg
vtzceg	vtzcg
kplkwp	kplkwp
yvncvz	yvncvz
emfafs	mffs
fetcsx	ftcsx
fqocsk	fqcsk
zjjcni	zjjcn
cnrmou	cnrm
igqkww	gqkww
rkissg	rkssg
nizwuy	nzwy
dmyrsq	dmyrsq
ydtqoy	ydtqy
nkhyla	nkhyl
smohsv	smhsv
zbubhg	zbbhg
induqr	ndqr
evqnxm	vqnxm
nxckac	nxckc
zqsemu	zqsm
qjaloy	qjly
aakbub	kbb
hskceq	hskcq
dxtqpn	dxtqpn
xzrwyj	xzrwyj
kwtlzo	kwtlz
fpnbbd	fpnbbd
nlneyz	nlnyz
wqsafi	wqsf
cdaqbq	cdqbq
wgkmxr	wgkmxr
dqfthr	dqfthr
wsswwvg	wsswwvg
fxklqnl	fxklqnl
nwrrnuc	nwrrnc
zwjcuvi	zwjcv
cexvwno	cxvwn
lpkvqay	lpkvqy
ocbvaag	cbvg
gqdpcyp	gqdpcyp
ybjxmeo	ybjxm
isonqzw	snqzw
dvqttrp	dvqttrp
emwvczh	mwvczh
monepmf	mnpmf
izgnbwt	zgnbwt
lprpqgx	lprpqgx
rburbmw	rbrbmw
hkqpeup	hkqpp
rlvxbpg	rlvxbpg
edjoxrn	djxrn
lfyjvza	lfyjvz
voucats	vcts
iyljsaz	yljsz
jdxsoaq	jdxsq
jcghbdo	jcghbd
ckprxok	ckprxk
hyfefip	hyffp
xohypyx	xhypyx
huljcbw	hljcbw
qhbnotm	qhbntm
najmtdq	njmtdq
yvoagie	yvg
fgkqbjt	fgkqbjt
maueeyk	myk
xchtmbd	xchtmbd
rwcbgvx	rwcbgvx
vosrjbj	vsrjbj
ndpauzc	ndpzc
eolompk	lmpk
ayyiiyf	yyyf
ouxihcq	xhcq
pefunof	pfnf
bcctsdn	bcctsdn
udgkgfj	dgkgfj
oneeqsb	nqsb
jrpnufh	jrpnfh
dzmhmcq	dzmhmcq
cbmyfvd	cbmyfvd
ofiijsz	fjsz
akzcdfn	kzcdfn
vskimnw	vskmnw
ycvqkuc	ycvqkc
eivsuaf	vsf
bkebqbx	bkbqbx
iogalvi	glv
lbyvxlk	lbyvxlk
kpakrpp	kpkrpp
smbgnta	smbgnt
dtdpjxv	dtdpjxv
zyxqzkt	zyxqzkt
fiardsi	frds
evgyajb	vgyjb
vnnzrzq	vnnzrzq
zbfyhpr	zbfyhpr
aketadb	ktdb
bxvkwst	bxvkwst
sitrpmx	strpmx
ygrernr	ygrrnr
dtltjkm	dtltjkm
npyepea	npyp
plbgbrw	plbgbrw
euyhohy	yhhy
lkuprfa	lkprf
gmakcsz	gmkcsz
liruery	lrry
fketvbk	fktvbk
gsxddft	gsxddft
xcbyurb	xcbyrb
laivdan	lvdn
xpuudco	xpdc
guauadn	gdn
mqzieoa	mqz
tzwtwvv	tzwtwvv
qqkqxnm	qqkqxnm
rqsspga	rqsspg
ljzwlji	ljzwlj
jwvgoho	jwvgh
cduqdyd	cdqdyd
vhtzpab	vhtzpb
yldqcdr	yldqcdr
noekjrq	nkjrq
ssauzou	ssz
ippeqau	ppq
oyciaxg	ycxg
ajsxtck	jsxtck
khexdvt	khxdvt
gcsvdan	gcsvdn
gfhtsxu	gfhtsx
qwpbqfg	qwpbqfg
pyuzvsl	pyzvsl
medhokl	mdhkl
uaeuaitn	tn
gzjmwpwc	gzjmwpwc
ezoaazpd	zzpd
auktfmbk	ktfmbk
atxubtfh	txbtfh
fpestqrj	fpstqrj
nftryryc	nftryryc
ohdrphjp	hdrphjp
quuabbtr	qbbtr
axlugwvj	xlgwvj
awznustt	wznstt
zellizvz	zllzvz
bqtmutyl	bqtmtyl
lcjxvufr	lcjxvfr
mrubxkwz	mrbxkwz
mibbqyzp	mbbqyzp
wghhcnys	wghhcnys
lwmmoqxr	lwmmqxr
smrpecrt	smrpcrt
usvjhfwc	svjhfwc
amgcfjow	mgcfjw
kncdsmel	kncdsml
bdehzkbi	bdhzkb
bvvgtoom	bvvgtm
apxrcpbe	pxrcpb
fdplhdtz	fdplhdtz
msqjkclc	msqjkclc
yqodaxxi	yqdxx
uniswyfe	nswyf
isjymcmr	sjymcmr
dicxykuw	dcxykw
zzuanftu	zznft
kosrgoiu	ksrg
pawphbly	pwphbly
bbdczwbz	bbdczwbz
eegnnybk	gnnybk
vtjpxqtv	vtjpxqtv
lpyvcvxg	lpyvcvxg
noivgpxr	nvgpxr
ivchrisl	vchrsl
jcgqdaoo	jcgqd
insnjdus	nsnjds
drjxkvij	drjxkvj
hdrptdac	hdrptdc
uaopofxl	pfxl
kflbhmin	kflbhmn
rnkfkbwa	rnkfkbw
lttdhjjz	lttdhjjz
lhqrflmy	lhqrflmy
ygeosdrj	ygsdrj
aixirpci	xrpc
hdjvonzj	hdjvnzj
cihppqbn	chppqbn
nmevxyza	nmvxyz
ytteozlp	yttzlp
ldjpozmd	ldjpzmd
oswwqcwa	swwqcw
gbpfgizk	gbpfgzk
thcxjbbl	thcxjbbl
kpmsmvya	kpmsmvy
ktjxoppi	ktjxpp
wnmvqkxu	wnmvqkx
llhmgeza	llhmgz
gdrafptf	gdrfptf
gueymaxf	gymxf
jiwwbrcg	jwwbrcg
bsdwzbzq	bsdwzbzq
yalkowfw	ylkwfw
hlrkbjxm	hlrkbjxm
jskdkjmy	jskdkjmy
pzlqzzsr	pzlqzzsr
qazrqsxz	qzrqsxz
cvmnqxsv	cvmnqxsv
qxnqhnxu	qxnqhnx
lhirbesp	lhrbsp
inmsgfov	nmsgfv
kglokavm	kglkvm
yzlrkwmr	yzlrkwmr
qpvywqib	qpvywqb
snksuoru	snksr
jzyagveb	jzygvb
rihzhpsy	rhzhpsy
chluburt	chlbrt
pjrpbrfx	pjrpbrfx
cwbchngp	cwbchngp
qelgczzx	qlgczzx
btisolnt	btslnt
ogapdcog	gpdcg
qrsvmwza	qrsvmwz
psusqkaw	pssqkw
kojjplpx	kjjplpx
kkakkdve	kkkkdv
eacteqnh	ctqnh
njvfrpiz	njvfrpz
hbcvegon	hbcvgn
dgiijakb	dgjkb
kuinuptz	knptz
itbuvjrj	tbvjrj
fnozetds	fnztds
pqgvofyo	pqgvfy
ipkzjnenq	pkzjnnq
apbyaclck	pbyclck
xkqqmcnmm	xkqqmcnmm
xhxixgzfg	xhxxgzfg
utdihnfbl	tdhnfbl
olvrhdhdh	lvrhdhdh
glgihuoad	glghd
urnaqbgmm	rnqbgmm
lopaqplyx	lpqplyx
qjahyszli	qjhyszl
mcgyhvivh	mcgyhvvh
yhtqrwmlf	yhtqrwmlf
uwgizrnfp	wgzrnfp
zfdbypufn	zfdbypfn
hhpeohjcd	hhphjcd
bnhqoatpb	bnhqtpb
dtedeiaus	dtds
idqsulxjp	dqslxjp
bhnzumtwk	bhnzmtwk
zaefyhmrc	zfyhmrc
xhxrpsdjb	xhxrpsdjb
ixrafdyxr	xrfdyxr
ljfgledcl	ljfgldcl
eeydojwqw	ydjwqw
yztfgarjj	yztfgrjj
eyhsmvphy	yhsmvphy
eiupahasd	phsd
guumbuchx	gmbchx
yzlvdjunv	yzlvdjnv
kqwmfsteg	kqwmfstg
mqrynafoe	mqrynf
ehhmrthfg	hhmrthfg
sluxtudce	slxtdc
vdgaahicn	vdghcn
ajgxgtoid	jgxgtd
pyanfpwlt	pynfpwlt
fuqwikeze	fqwkz
ofybcczab	fybcczb
yvhozrfcg	yvhzrfcg
pmnfsxlqg	pmnfsxlqg
qywaqxhgc	qywqxhgc
jbqmrpaki	jbqmrpk
coywtfexj	cywtfxj
mlkxiikil	mlkxkl
kcnucpfso	kcncpfs
ljtwotisv	ljtwtsv
cnyrsxtjs	cnyrsxtjs
snfkgqian	snfkgqn
tcfcquqwi	tcfcqqw
vonlgnfjp	vnlgnfjp
bwiwlxlvl	bwwlxlvl
tdbprsvxt	tdbprsvxt
wdowxtylw	wdwxtylw
foimykcih	fmykch
esajvguuk	sjvgk
kfzoyunic	kfzync
brwqjsvtk	brwqjsvtk
snjjawzqo	snjjwzq
yllrzqwvg	yllrzqwvg
hhmjnbtma	hhmjnbtm
gyrrxwcuq	gyrrxwcq
fjppkyupp	fjppkypp
apmdcgghw	pmdcgghw
bilvsaqja	blvsqj
qwdsvspyn	qwdsvspyn
wmwdwntff	wmwdwntff
erzmrvfmw	rzmrvfmw
zsdtlbbdb	zsdtlbbdb
hpqfwpabn	hpqfwpbn
yzmwtasyb	yzmwtsyb
qidtffziq	qdtffzq
ogiedpbud	gdpbd
maucuqsjn	mcqsjn
driyrswof	dryrswf
qgxyylhqw	qgxyylhqw
rdubvuxql	rdbvxql
pwntkgaov	pwntkgv
nhukjcevv	nhkjcvv
bwhgmxzxj	bwhgmxzxj
jutuhtsnw	jthtsnw
cdkxnzeix	cdkxnzx
jgrsofsye	jgrsfsy
kvvjmxysz	kvvjmxysz
howpdxnrw	hwpdxnrw
dyyqteujg	dyyqtjg
kzccqgyhc	kzccqgyhc
knejrjwiz	knjrjwz
jfaxpvofo	jfxpvf
tiwiaasia	tws
evvtnomre	vvtnmr
qovbrqkxz	qvbrqkxz
xuxxntzjl	xxxntzjl
bwqtvydsn	bwqtvydsn
kjxiwgoma	kjxwgm
lcresksup	lcrsksp
apfildhqz	pfldhqz
jshsafkim	jshsfkm
zgtqislea	zgtqsl
kpjapagpu	kpjpgp
isckxvtgj	sckxvtgj