lynqc	lynqclynqc
fngme	fngmefngme
zaxql	zaxqlzaxql
nrwwg	nrwwgnrwwg
bqjwd	bqjwdbqjwd
nzoby	nzobynzoby
ltxfs	ltxfsltxfs
eaztm	eaztmeaztm
bmvqb	bmvqbbmvqb
rywky	rywkyrywky
zhjlm	zhjlmzhjlm
ehriv	ehrivehriv
tmmlu	tmmlutmmlu
zluoa	zluoazluoa
sphih	sphihsphih
ipsxy	ipsxyipsxy
vpdvd	vpdvdvpdvd
pkvan	pkvanpkvan
sknlh	sknlhsknlh
dreof	dreofdreof
nwfqy	nwfqynwfqy
ptjiv	ptjivptjiv
wckej	wckejwckej
lqinq	lqinqlqinq
oxxde	oxxdeoxxde
jojvd	jojvdjojvd
offdr	offdroffdr
cnbjl	cnbjlcnbjl
deggb	deggbdeggb
waqcj	waqcjwaqcj
kaclv	kaclvkaclv
dblvx	dblvxdblvx
eewhl	eewhleewhl
zhqus	zhquszhqus
hzyzr	hzyzrhzyzr
ksmgs	ksmgsksmgs
vcmdp	vcmdpvcmdp
lqwma	lqwmalqwma
wajgh	wajghwajgh
zseiv	zseivzseiv
jenpn	jenpnjenpn
omcvi	omcviomcvi
sjdbg	sjdbgsjdbg
wirmo	wirmowirmo
vofiz	vofizvofiz
uydxq	uydxquydxq
qbfzs	qbfzsqbfzs
azrob	azrobazrob
uxrvd	uxrvduxrvd
jblpl	jblpljblpl
iyics	iyicsiyics
rywra	rywrarywra
dpkbx	dpkbxdpkbx
qmdcf	qmdcfqmdcf
aklod	aklodaklod
ftoee	ftoeeftoee
hexdr	hexdrhexdr
vvtbd	vvtbdvvtbd
jjrxi	jjrxijjrxi
ggfjd	ggfjdggfjd
pqlwa	pqlwapqlwa
qiqeg	qiqegqiqeg
ohzdo	ohzdoohzdo
iyowo	iyowoiyowo
wccxy	wccxywccxy
vvkas	vvkasvvkas
xbsxk	xbsxkxbsxk
iprkb	iprkbiprkb
hvsax	hvsaxhvsax
igqew	igqewigqew
dbfun	dbfundbfun
akqoe	akqoeakqoe
cnwwi	cnwwicnwwi
nxnuj	nxnujnxnuj
bnfhf	bnfhfbnfhf
ssqqd	ssqqdssqqd
kyxxf	kyxxfkyxxf
ofbbp	ofbbpofbbp
vtwyt	vtwytvtwyt
vqmsc	vqmscvqmsc
nmmcb	nmmcbnmmcb
cebgl	cebglcebgl
erpwz	erpwzerpwz
wejsi	wejsiwejsi
lkiyn	lkiynlkiyn
wbjmu	wbjmuwbjmu
vmkjn	vmkjnvmkjn
qcyyp	qcyypqcyyp
oaipd	oaipdoaipd
qfide	qfideqfide
mucbr	mucbrmucbr
unngh	unnghunngh
ryvba	ryvbaryvba
fczim	fczimfczim
piwjs	piwjspiwjs
svawj	svawjsvawj
oiijk	oiijkoiijk
rwots	rwotsrwots
kzkrg	kzkrgkzkrg
lrbei	lrbeilrbei
myfany	myfanymyfany
mhpzxo	mhpzxomhpzxo
ueresz	uereszueresz
germuv	germuvgermuv
btimqq	btimqqbtimqq
auivze	auivzeauivze
ltzuzv	ltzuzvltzuzv
gsygpz	gsygpzgsygpz
bgnbis	bgnbisbgnbis
zzukin	zzukinzzukin
ugmblv	ugmblvugmblv
yzgsnr	yzgsnryzgsnr
ofmrjz	ofmrjzofmrjz
xqtsus	xqtsusxqtsus
lpwnno	lpwnnolpwnno
imvfak	imvfakimvfak
uchmih	uchmihuchmih
ayvsab	ayvsabayvsab
ehcixn	ehcixnehcixn
bjqrdr	bjqrdrbjqrdr
ssucoe	ssucoessucoe
bsardx	bsardxbsardx
xhovda	xhovdaxhovda
srvzpd	srvzpdsrvzpd
nlwzyw	nlwzywnlwzyw
eheslg	eheslgeheslg
giufln	giuflngiufln
wfqffj	wfqffjwfqffj
kcfaie	kcfaiekcfaie
zzmaij	zzmaijzzmaij
rxjooq	rxjooqrxjooq
flvkqu	flvkquflvkqu
vtrsgd	vtrsgdvtrsgd
uebtgv	uebtgvuebtgv
hxnxgw	hxnxgwhxnxgw
cetxhy	cetxhycetxhy
yjlywx	yjlywxyjlywx
iukayv	iukayviukayv
vaysoh	vaysohvaysoh
nbbqcg	nbbqcgnbbqcg
crjejp	crjejpcrjejp
jpyxhi	jpyxhijpyxhi
vodnfy	vodnfyvodnfy
ttpcxc	ttpcxcttpcxc
prgejv	prgejvprgejv
iriehl	iriehliriehl
yisyti	yisytiyisyti
cdkqww	cdkqwwcdkqww
onmqgn	onmqgnonmqgn
plzheh	plzhehplzheh
uzusnq	uzusnquzusnq
lqddql	lqddqllqddql
dmrbtv	dmrbtvdmrbtv
jkeesw	jkeeswjkeesw
rtilvw	rtilvwrtilvw
rhryuc	rhryucrhryuc
jwxhso	jwxhsojwxhso
xsosmx	xsosmxxsosmx
mceezz	mceezzmceezz
znediz	znedizznediz
grcprq	grcprqgrcprq
ylgeyb	ylgeybylgeyb
ycefku	ycefkuycefku
rtgvwh	rtgvwhrtgvwh
pdjime	pdjimepdjime
sfrsig	sfrsigsfrsig
zbmvdt	zbmvdtzbmvdt
dsnsei	dsnseidsnsei
eqmsvk	eqmsvkeqmsvk
jmyqih	jmyqihjmyqih
pspvsn	pspvsnpspvsn
apsimp	apsimpapsimp
kmccuo	kmccuokmccuo
jebrks	jebrksjebrks
sinxiq	sinxiqsinxiq
rdasyb	rdasybrdasyb
cuftax	cuftaxcuftax
ngpadk	ngpadkngpadk
foknxs	foknxsfoknxs
outrrw	outrrwoutrrw
syzthg	syzthgsyzthg
xwhmuo	xwhmuoxwhmuo
tzydbn	tzydbntzydbn
iikwbr	iikwbriikwbr
hmueab	hmueabhmueab
tdiquc	tdiquctdiquc
nhickh	nhickhnhickh
eirxzt	eirxzteirxzt
lrtcff	lrtcfflrtcff
lazgmj	lazgmjlazgmj
owqbid	owqbidowqbid
ccbknl	ccbknlccbknl
dmlwfm	dmlwfmdmlwfm
weqjuo	weqjuoweqjuo
usyatp	usyatpusyatp
uitdkq	uitdkquitdkq
ynuwcn	ynuwcnynuwcn
gygxbj	gygxbjgygxbj
ikndgc	ikndgcikndgc
klhrgc	klhrgcklhrgc
unfrksb	unfrksbunfrksb
cgeheci	cgehecicgeheci
pblunrc	pblunrcpblunrc
uydjoya	uydjoyauydjoya
rvnpdfg	rvnpdfgrvnpdfg
uhtcspq	uhtcspquhtcspq
qzapdcf	qzapdcfqzapdcf
qshxaif	qshxaifqshxaif
dzzigzg	dzzigzgdzzigzg
iwimcvy	iwimcvyiwimcvy
lmllzhb	lmllzhblmllzhb
czffwcs	czffwcsczffwcs
jkfloyb	jkfloybjkfloyb
lklpsic	lklpsiclklpsic
dtuuzkv	dtuuzkvdtuuzkv
voreoas	voreoasvoreoas
nzhzazd	nzhzazdnzhzazd
lofkkoz	lofkkozlofkkoz
nhxoqod	nhxoqodnhxoqod
zdktfkr	zdktfkrzdktfkr
ikysevr	ikysevrikysevr
cxbcifa	cxbcifacxbcifa
geivbbh	geivbbhgeivbbh
jflvady	jflvadyjflvady
kbnuzzg	kbnuzzgkbnuzzg
pfksrvd	pfksrvdpfksrvd
pyxdqpe	pyxdqpepyxdqpe
jeqabva	jeqabvajeqabva
xsyqnnu	xsyqnnuxsyqnnu
urnflav	urnflavurnflav
hatrhbg	hatrhbghatrhbg
dyecvgt	dyecvgtdyecvgt
fyebjbf	fyebjbffyebjbf
rjrnvkg	rjrnvkgrjrnvkg
uptxnfk	uptxnfkuptxnfk
fqdqnap	fqdqnapfqdqnap
qzckncy	qzckncyqzckncy
yjbbuef	yjbbuefyjbbuef
vgqfgom	vgqfgomvgqfgom
rqadhho	rqadhhorqadhho
ntlvsuz	ntlvsuzntlvsuz
lblhvjw	lblhvjwlblhvjw
ftcdvuy	ftcdvuyftcdvuy
lykmlye	lykmlyelykmlye
dgdcgpr	dgdcgprdgdcgpr
pbabkmr	pbabkmrpbabkmr
lhfymtu	lhfymtulhfymtu
yktcbmf	yktcbmfyktcbmf
tvmygkn	tvmygkntvmygkn
wszaiar	wszaiarwszaiar
dgkysdl	dgkysdldgkysdl
epaiwum	epaiwumepaiwum
zehgewp	zehgewpzehgewp
hkuctld	hkuctldhkuctld
kqmzygs	kqmzygskqmzygs
ffwufce	ffwufceffwufce
mfgnxxa	mfgnxxamfgnxxa
eqzusyj	eqzusyjeqzusyj
pukuzyb	pukuzybpukuzyb
admxnzn	admxnznadmxnzn
ogesrgj	ogesrgjogesrgj
iziyonl	iziyonliziyonl
azjyeco	azjyecoazjyeco
eynrmvu	eynrmvueynrmvu
uuqxsvl	uuqxsvluuqxsvl
zcjhcuq	zcjhcuqzcjhcuq
ufpqyxo	ufpqyxoufpqyxo
umbwxav	umbwxavumbwxav
vemfpbg	vemfpbgvemfpbg
ikycszg	ikycszgikycszg
mcphfxp	mcphfxpmcphfxp
dxoybbl	dxoybbldxoybbl
vooqike	vooqikevooqike
klkzzhn	klkzzhnklkzzhn
wcykedh	wcykedhwcykedh
diqzaak	diqzaakdiqzaak
ohttzfv	ohttzfvohttzfv
rtebaax	rtebaaxrtebaax
vobsimj	vobsimjvobsimj
tgugghb	tgugghbtgugghb
estqdjs	estqdjsestqdjs
xudjtfi	xudjtfixudjtfi
azcqueo	azcqueoazcqueo
juqtjkx	juqtjkxjuqtjkx
rjqdmpz	rjqdmpzrjqdmpz
xcqlent	xcqlentxcqlent
miwxgjf	miwxgjfmiwxgjf
qibpele	qibpeleqibpele
dcmpjqc	dcmpjqcdcmpjqc
aqyrvsv	aqyrvsvaqyrvsv
kpkreoq	kpkreoqkpkreoq
oryunjh	oryunjhoryunjh
szbhyvs	szbhyvsszbhyvs
rvxdvro	rvxdvrorvxdvro
cfrzcxt	cfrzcxtcfrzcxt
inhfuit	inhfuitinhfuit
ekzwbue	ekzwbueekzwbue
yuvqfik	yuvqfikyuvqfik
gpdubbo	gpdubbogpdubbo
emzaugr	emzaugremzaugr
iagiarmq	iagiarmqiagiarmq
ezwyvgtz	ezwyvgtzezwyvgtz
tmtqzsiw	tmtqzsiwtmtqzsiw
lhxykapu	lhxykapulhxykapu
frwzfdtg	frwzfdtgfrwzfdtg
jejulmvl	jejulmvljejulmvl
nracovtk	nracovtknracovtk
ldfyvbsg	ldfyvbsgldfyvbsg
zcnszaim	zcnszaimzcnszaim
mfvnzufi	mfvnzufimfvnzufi
jpzwgjme	jpzwgjmejpzwgjme
cqvfiymx	cqvfiymxcqvfiymx
oliuxrgd	oliuxrgdoliuxrgd
tretwktb	tretwktbtretwktb
mfqihbki	mfqihbkimfqihbki
pbsayaow	pbsayaowpbsayaow
psbuemxz	psbuemxzpsbuemxz
lwzootuz	lwzootuzlwzootuz
bmwhwetv	bmwhwetvbmwhwetv
yxxegiei	yxxegieiyxxegiei
obzuxcdg	obzuxcdgobzuxcdg
nbetqizd	nbetqizdnbetqizd
sercccof	sercccofsercccof
qzppdwcj	qzppdwcjqzppdwcj
bpydyeeh	bpydyeehbpydyeeh
zdjisiba	zdjisibazdjisiba
cdebzafl	cdebzaflcdebzafl
dszvwucx	dszvwucxdszvwucx
eifxmykl	eifxmykleifxmykl
wmmdbpje	wmmdbpjewmmdbpje
sacpisnk	sacpisnksacpisnk
hefodddo	hefodddohefodddo
fwtcmdyz	fwtcmdyzfwtcmdyz
pvawigab	pvawigabpvawigab
ramqgtzv	ramqgtzvramqgtzv
naajegcv	naajegcvnaajegcv
tgkpsgae	tgkpsgaetgkpsgae
ylootbum	ylootbumylootbum
apwzyser	apwzyserapwzyser
kkcwhzze	kkcwhzzekkcwhzze
cazsttsy	cazsttsycazsttsy
spyxhjaf	spyxhjafspyxhjaf
horprqrq	horprqrqhorprqrq
pwxwqveb	pwxwqvebpwxwqveb
ibsjqtmg	ibsjqtmgibsjqtmg
xcclrqvm	xcclrqvmxcclrqvm
sitnrzcp	sitnrzcpsitnrzcp
ntrdkgim	ntrdkgimntrdkgim
zautgvmu	zautgvmuzautgvmu
cmasdhrg	cmasdhrgcmasdhrg
mkpkaznp	mkpkaznpmkpkaznp
admsqbwa	admsqbwaadmsqbwa
rpmvmwgb	rpmvmwgbrpmvmwgb
qbvlygac	qbvlygacqbvlygac
leghhbvz	leghhbvzleghhbvz
lxpoztts	lxpozttslxpoztts
gklirwms	gklirwmsgklirwms
yymidziz	yymidzizyymidziz
wguzzmvy	wguzzmvywguzzmvy
fsvqdrkc	fsvqdrkcfsvqdrkc
hzikkhac	hzikkhachzikkhac
tkprasol	tkprasoltkprasol
osewoidt	osewoidtosewoidt
qucfhewv	qucfhewvqucfhewv
mzisvjrv	mzisvjrvmzisvjrv
xourhmri	xourhmrixourhmri
jvirdbhw	jvirdbhwjvirdbhw
wwdyvwgf	wwdyvwgfwwdyvwgf
lfzstasu	lfzstasulfzstasu
jygaviwi	jygaviwijygaviwi
wiyoysxb	wiyoysxbwiyoysxb
wlleffya	wlleffyawlleffya
biemcvjs	biemcvjsbiemcvjs
geomfoup	geomfoupgeomfoup
wiemthsa	wiemthsawiemthsa
jcxhxfdm	jcxhxfdmjcxhxfdm
reujzzgr	reujzzgrreujzzgr
lxwpwlns	lxwpwlnslxwpwlns
vwczmnio	vwczmniovwczmnio
jtctvkyx	jtctvkyxjtctvkyx
mrytroaj	mrytroajmrytroaj
lotfkgju	lotfkgjulotfkgju
pksaqwlx	pksaqwlxpksaqwlx
hwslukvi	hwslukvihwslukvi
yrighgbr	yrighgbryrighgbr
onhfvxey	onhfvxeyonhfvxey
jtyqkmme	jtyqkmmejtyqkmme
cunsgmot	cunsgmotcunsgmot
symdukrg	symdukrgsymdukrg
uktfsilj	uktfsiljuktfsilj
imjagnpw	imjagnpwimjagnpw
ltppwroi	ltppwroiltppwroi
akmujjgh	akmujjghakmujjgh
joigygpv	joigygpvjoigygpv
vmejutyw	vmejutywvmejutyw
tflxouod	tflxouodtflxouod
dajfhfmx	dajfhfmxdajfhfmx
hqxspkls	hqxspklshqxspkls
ollmpfel	ollmpfelollmpfel
qpughqbc	qpughqbcqpughqbc
lhghdrajq	lhghdrajqlhghdrajq
oddyaxynp	oddyaxynpoddyaxynp
gwnneglfg	gwnneglfggwnneglfg
bwrzptpoo	bwrzptpoobwrzptpoo
mcnthqrxe	mcnthqrxemcnthqrxe
cykfwxqcc	cykfwxqcccykfwxqcc
uyjjmiwio	uyjjmiwiouyjjmiwio
dtxgvyvya	dtxgvyvyadtxgvyvya
rzjqvicvs	rzjqvicvsrzjqvicvs
nrdwlmcca	nrdwlmccanrdwlmcca
tawgyhxyz	tawgyhxyztawgyhxyz
sxjvzrinv	sxjvzrinvsxjvzrinv
dgkdgxsdn	dgkdgxsdndgkdgxsdn
efokidqhv	efokidqhvefokidqhv
lynrcjjol	lynrcjjollynrcjjol
dqxqwacew	dqxqwacewdqxqwacew
mtnlxqzcw	mtnlxqzcwmtnlxqzcw
afsyxvvbr	afsyxvvbrafsyxvvbr
rjxqjlmpx	rjxqjlmpxrjxqjlmpx
bncrjxnxs	bncrjxnxsbncrjxnxs
lkdelpluv	lkdelpluvlkdelpluv
taqhfpmiu	taqhfpmiutaqhfpmiu
wutthztni	wutthztniwutthztni
itrebglfv	itrebglfvitrebglfv
odloorama	odlooramaodloorama
ugnuouaol	ugnuouaolugnuouaol
emxkbqnze	emxkbqnzeemxkbqnze
ajudvmxol	ajudvmxolajudvmxol
djeeqljix	djeeqljixdjeeqljix
rxihyexse	rxihyexserxihyexse
zvgulhyzx	zvgulhyzxzvgulhyzx
afygmohew	afygmohewafygmohew
iurdprdcw	iurdprdcwiurdprdcw
xteioxqxr	xteioxqxrxteioxqxr
lvhvkhbxm	lvhvkhbxmlvhvkhbxm
mrdrklfon	mrdrklfonmrdrklfon
laqjgrori	laqjgrorilaqjgrori
gxbtxpjql	gxbtxpjqlgxbtxpjql
qqlqcdvvr	qqlqcdvvrqqlqcdvvr
kpcuduytt	kpcuduyttkpcuduytt
fcmqcobjg	fcmqcobjgfcmqcobjg
kyaymekkg	kyaymekkgkyaymekkg
sjemnpxko	sjemnpxkosjemnpxko
ldtelkknt	ldtelkkntldtelkknt
rhdnhudbr	rhdnhudbrrhdnhudbr
bevtmgajl	bevtmgajlbevtmgajl
gqilmschj	gqilmschjgqilmschj
nrpugyrls	nrpugyrlsnrpugyrls
njdqszrnv	njdqszrnvnjdqszrnv
yykhkkhkt	yykhkkhktyykhkkhkt
idmqwudxa	idmqwudxaidmqwudxa
aruldlnxg	aruldlnxgaruldlnxg
gkrvwchfx	gkrvwchfxgkrvwchfx
mpjpnrodg	mpjpnrodgmpjpnrodg
zprtbqttu	zprtbqttuzprtbqttu
yojubqgpf	yojubqgpfyojubqgpf
puyuvzltq	puyuvzltqpuyuvzltq
amdzdzxrv	amdzdzxrvamdzdzxrv
junllqtkh	junllqtkhjunllqtkh
rrgfuycyd	rrgfuycydrrgfuycyd
pjzkhmrxw	pjzkhmrxwpjzkhmrxw
iywuongnz	iywuongnziywuongnz
ybzyzqslg	ybzyzqslgybzyzqslg
rnefaujxs	rnefaujxsrnefaujxs
lpiwivzym	lpiwivzymlpiwivzym
glwqihabn	glwqihabnglwqihabn
nhvdfwcka	nhvdfwckanhvdfwcka
ogtmveaxb	ogtmveaxbogtmveaxb
yzthifnos	yzthifnosyzthifnos
gjpbvkxxv	gjpbvkxxvgjpbvkxxv
aiheyrgar	aiheyrgaraiheyrgar
ztsowkskv	ztsowkskvztsowkskv
ctvyyrqny	ctvyyrqnyctvyyrqny
vktmfporr	vktmfporrvktmfporr
gbdnqtuhu	gbdnqtuhugbdnqtuhu
amypqpmus	amypqpmusamypqpmus
jvpocwttn	jvpocwttnjvpocwttn
lgwqkcmij	lgwqkcmijlgwqkcmij
asqzrnxph	asqzrnxphasqzrnxph
jgoipypqp	jgoipypqpjgoipypqp
dqcjgbmhw	dqcjgbmhwdqcjgbmhw
padynnucn	padynnucnpadynnucn
cmrwfpwkr	cmrwfpwkrcmrwfpwkr
qywhzobhi	qywhzobhiqywhzobhi
qkuxcnvyd	qkuxcnvydqkuxcnvyd
svtsrzhni	svtsrzhnisvtsrzhni
pwoatetee	pwoateteepwoatetee
swupzsyiv	swupzsyivswupzsyiv
pvlyxhtwo	pvlyxhtwopvlyxhtwo
rmlgwdyls	rmlgwdylsrmlgwdyls
yuxcbtxmx	yuxcbtxmxyuxcbtxmx
iqhsqniqa	iqhsqniqaiqhsqniqa
buzryqvqd	buzryqvqdbuzryqvqd
jlrtorksn	jlrtorksnjlrtorksn
odxhlftkr	odxhlftkrodxhlftkr
gpkvxzskk	gpkvxzskkgpkvxzskk
linnoywty	linnoywtylinnoywty
dkyjdjoea	dkyjdjoeadkyjdjoea
bwxnfgsdq	bwxnfgsdqbwxnfgsdq
kxanflxho	kxanflxhokxanflxho